21212121212121220000202121212121
21212121133131320000303131313131
21212121220000000000000000001516
21212121231200000000000000002526
21212113313200000000000000002526
21133132000000000000003300003536
21220000000000000000000000000000
31320000000000000000000000000000
00000000000034000000000000001516
00000000000000000000000000002526
11120000340000000034000000002526
21220000000000000000000000002526
21221516161617000015161616162926
21222526262627000025262626262626

image image:tiles
location 5 5
sprite @8,6 sprite:hero 0x00000000
sprite @11,10 sprite:princess 0x00000000
