21212121212121220200202121212121
31313131313131320200303131313131
41414141414141420200404141414141
61616161616161620200606161616161
00000000000000000000000000001516
00000000000000000000000000003536
01010101010101010101010100000000
01010101010101010101010100000000
01010101010101010101010100001516
00000000000000000000000000002526
11120000000000000000000000002526
21220200000000000000000000002526
21221a16161617000015161616162926
21222a26262627000025262626262626

image image:tiles
location 5 5
sprite @8,6 sprite:hero 0x00000000
sprite @11,10 sprite:princess 0x00000000
