21212121212121212121212121212121
21211331313131313131313131142121
212122401c1d411c1d411c1d42202121
212122602c2d612c2d612c2d62202121
21212202000000000000000000202121
21212202001e1f00001e1f0000202121
21212202002e2f00002e2f0000202121
21212202707171717171717200202121
21212202808181818181818200202121
21212202808181818181818200202121
21212202909191919191919200202121
21212202000000000000000000202121
21212311111112000010111111242121
21212121212122020020212121212121

image image:tiles
location 3 5
sprite @6,9 sprite:hero 0x00000000
