21212100212121220220212121212121
31313100313131320230313131313131
41414100414141420240414141414141
61616100616161620260616161616161
00000000000000000700000400001516
00000000000000000000000000003536
01010101010101010101010100000000
01010101010101010101010100000000
01010101010101010101010100001516
00000000000000000000000000002526
11120000040000000000000000002526
21220200000000000000000000002526
21221a16161617071516161600162926
21222a26262627002526262600262626

image image:tiles
location 5 5
sprite @8,6 sprite:hero 0x00000000
sprite @11,10 sprite:princess 0x00000000
treadle @4,10 (u16:fld)homelock1
switchable @7,12 (u16:fld)homelock1
stompbox @11,4 (u16:fld)homelock2
switchable @8,4 (u16:fld)homelock2
sprite @5,4 sprite:flamethrower 0x02 4 (u16:fld)homelock1
