21212121212121212121212121212121
21211331313131313131313131142121
21212240414141414141414142202121
21212260616161616161616162202121
21212202000000000000000000202121
21212202000000000000000000202121
21212202000064000063000000202121
21212202000000000000000000202121
21212202000000000000000000202121
212122020000000000f0000000202121
21212202000000000000000000202121
21212202000000000000000000202121
21212311111112000010111111242121
21212121212122020020212121212121

image image:tiles
location 3 5
sprite @6,9 sprite:hero 0x00000000
sprite @9,7 sprite:treasure (u8:fld)got_bomb 0x08 1 0
