22020000202121212121212121212121
22020000303131311421212121212121
22020000404141422021212121212121
22020000606161622021212121212121
220200f0000000003031313131313131
2202f0f0f00000004041414141414141
220200f0000000006061616161616161
220200f0000000000000000000000000
220200f0000000000000000000000000
22020000000000000000000000000000
23111111111111111111111111111111
21212121212121212121212121212121
21212121212121212121212121212121
21212121212121212121212121212121

image image:tiles
location 8 7
