22020000202121212121212121212121
22020000303131311421212121212121
22020000404141422021212121212121
22020000606161622021212121212121
22020000000700003031313131313131
23111111111112004041414141414141
21212121212122026061616161616161
21212121212122020000000000000000
21212121212122020000000000000000
21212121212122020000000000000000
21212121212123111200000010111111
21212121212121212202040020212121
21212121212121212202000020212121
21212121212121212311111124212121

image image:tiles
location 8 7
stompbox @10,11 (u16:fld)oneway1
switchable @5,4 (u16:fld)oneway1
