22020000202113311421212121212121
22020000303132632021212121212121
220200004041423d2021212121212121
22020000606162042021212121212121
22020000000700003031313131313131
23111111111112004041494a4f414141
21212121212122026061595a5f616161
21212121212122020000000000000000
21212121212122020000000000000000
21212121212122020000000000000000
21212121212123111200000010111111
21212121212121212202040020212121
21212121212121212202000020212121
21212121212121212311111124212121

image image:tiles
location 8 7
stompbox @10,11 (u16:fld)oneway1
switchable @5,4 (u16:fld)oneway1
switchable @7,2 (u16:fld)knivesoff
stompbox @7,3 (u16:fld)knivesoff
