13313131313200000000303131313114
22404141414200000000404141414220
32606161616200000000606161616220
42020000000000000000000000000020
62020000000000000000000000000020
00000000000000000000000000000020
00000000000000000000000000000020
00000000000000000000000000000020
12000000000000000000000000000020
22020000000000000000000000000020
22020000000000000000000000000020
22020000000000000000000000000020
22020000000000000000000000000020
23111111111111111111111111111124

image image:tiles
location 11 6
sprite @6,9 sprite:treasure (u8:fld)got_bomb 0x08 0x01 0x00
