13313131313131313131313131313114
22404141414141414141414141414220
22606161616161616161616161616220
22020000000000000000000000000020
22020000000000000000000000000020
22020000000000000000000000000020
22020000000000000000000000000020
22020000000000000000000000000020
22020000000000000000000000000020
22020000000000000000000000000020
22020000000000000000000000000020
22020000000000000000000000000020
22020000000000000000000000000020
23111111111200000000101111111124

image image:tiles
location 11 5
sprite @7,5 sprite:princess 0x00000000
