13313131313131313131313131313114
22404141414141414141414141414220
22606161616161616161616161616220
22020000000000000000000000000020
220200f0f00000000000000000000020
220200f00000f0f00000000000000020
2202f0f00000f0f00000000000000020
22020000000000f00000000000000020
22020000000000f0f000000000000020
22020000000000000000000000000020
22020000001516170000000000000020
22020000002526270000000000000020
23111111122526271011111111111124
21212121222a26272021212121212121

image image:tiles
location 5 5
