13313131313131313131313131313114
22404141414141414141414141414220
22606161616161616161616161616220
22020000000000000000000000000020
22020000000000000000000000000030
22020000000000000000000000000040
22020000000000000000000000000060
22020000000000000000f00000000000
22020000000000000000000000000000
22020000000000000000000000000010
22020000000000000000000000000020
22020000000000000000000000000020
22020000000000000000000000000020
23111111111111111111111111111124

image image:tiles
location 2 6
sprite @5,11 sprite:treasure (u8:fld)got_candy 0x08 0x01 0x00
