13313202003031313131313131313114
22404202004041414141414141414220
22606202006061616161616161616220
22020000000000000000000000000020
22020000000000000000000000000030
22020000000000000000000000000040
22020000000000000000000000000060
22020000000000000000000000000000
22020000000000000000000000000000
220200000000000000f0000000000010
22020000000000000000000000000020
22020000000000000000000000000020
22020000000000000000000000000020
23111111111111111111111111111124

image image:tiles
location 3 7
