13313202003031313131313131313114
22404202004041414141414141414220
22606202006061616161616161616220
22000000000000000000000000000020
22000000000000000000000000000030
22000000000000000000000000000040
22000000000000000000000000000060
22000000000000000000000000000000
22000000000000000000000000000000
220000000000000000f0000000000010
22000000000000000000000000000020
22000000000000000000000000000020
22000000000000000000000000000020
23111111111111111111111111111124

image image:tiles
location 3 7
