13313202003031313131313131313114
22404202004041414141414141414220
22606202006061616161616161616220
22020000000000000000000000000020
22020000000000000000000000000030
22020033000033000034000034000040
22020063020063020063020063020060
22020000000000000000000000000000
22020000000000000000000000000000
22020033000034000034000033000010
22020064020064020063020064020020
22020000000000000000000000000020
22020000000000000000000000000020
23111111111111111111111111111124

image image:tiles
location 3 7
sprite @2,12 sprite:bug 0x00000000
sprite @7,10 sprite:bug 0x00000000
sprite @10,5 sprite:bug 0x00000000
