21212121212113313131313131313114
212121212121224041414147484f4220
212121212121226061616157585f6220
21212121212122020000000000000020
31313131313132020400000000000030
4141414141414202000000003c000040
61616161616162020000000000000060
00000000000700000000000000000000
0000000000070000003c000000000000
11111111111112000000000000000010
21212121212122020000000000000020
21212121212122020000000000000020
21212121212122020000000000000020
21212121212123111111111111111124

image image:tiles
location 4 7
stompbox @8,4 (u16:fld)oneway2
switchable @5,8 (u16:fld)oneway2
switchable @5,7 (u16:fld)oneway2
sprite @8,11 sprite:bug 0x00000000
sprite @10,11 sprite:caterpillar 0x00000000
