21212121212113313131313131313114
21212121212122404141414141414220
21212121212122606161616161616220
21212121212122020000000000000020
31313131313132020400000000000030
41414141414142020000000000000040
61616161616162020000000000000060
00000000000700000000000000000000
00000000000700000000000000000000
11111111111112000000000000000010
21212121212122020000000000000020
21212121212122020000000000000020
21212121212122020000000000000020
21212121212123111111111111111124

image image:tiles
location 4 7
stompbox @8,4 (u16:fld)oneway2
switchable @5,8 (u16:fld)oneway2
switchable @5,7 (u16:fld)oneway2
