13313131313131313131313131313114
22404141414141414141414141414220
22606161616161616161616161616220
22020000000000000000000000000020
320200000000f0000000000000000030
4202000000f000000000000000000040
62020000f0f0f0f0f000000000000060
0000000000f000000000000000000000
000000000000f0000000000000000000
12000000000000000000000000000010
22020000000000000000000000000020
22020000000000000000000000000020
22020000000000000000000000000020
23111111111111111111111111111124

image image:tiles
location 4 7
