21212121212121212121212121212121
21212121212121212121212121212121
13313131313131313131313114212121
22404141414141414141414220212121
32606161616161616161616220212121
42020000000000000000000020212121
6202000000000000f000000020212121
00000000000000000000000020212121
00000000000000000000000020212121
11111111111111111200000020212121
21212121212121212202000020212121
21212121212121212202000020212121
21212121212121212202000020212121
21212121212121212202000020212121

image image:tiles
location 5 7
