21212121212121222a26272013311421
21212121212121222a26272022642021
13313131313131322a26272022642021
22404141414141422a26272022022021
32606161616161622a26272022022021
42020000000000002526272022022021
62020000000000002526273032042021
00000000000000002526276364022021
000000000000000035192816173c3031
11120000000000000035192628174041
21220200000000000000351926276061
21220200000000000000000b0b0b0700
2123111111111111120000251b271011
21212121212121212202002526272021

image image:tiles
location 5 7
stompbox @13,6 (u16:fld)shortcut1
switchable @14,11 (u16:fld)shortcut1
sprite @13,4 sprite:pot 0x00000000
