21212121212121222a26273014212121
21212121212121222a26276430142121
13313131313131322a26276363301421
22404141414141422a26281764632021
32606161616161622a19262817642021
42020000000000000035192628172021
620200f0000000000000351926272021
00000000000000000000002526272021
00000000000000000000002526272021
11111111111111111200002526272021
21212121212121212202002526272021
21212121212121212202002526272021
21212121212121212202002526272021
21212121212121212202002526272021

image image:tiles
location 5 7
