21212121212121222a26273014212121
21212121212113322a26276430142121
13313131313132642a26276363301421
22404141414142642a26281764632021
32606161616162043519262817642021
42020000000000000035192628172021
62020000000000000000351926272021
00000000000000000000002526272021
00000000000000000000002526273031
11111111111111111200002526274041
21212121212121212202003536376061
21212121212121212202000000000700
21212121212121212202001516171011
21212121212121212202002526272021

image image:tiles
location 5 7
stompbox @7,4 (u16:fld)shortcut1
switchable @14,11 (u16:fld)shortcut1
