21212121212121212202000020212121
21212121212121212202000020212121
31313131313131313202000020212121
41414141414141414202000020212121
61616161616161616202000020212121
00000000000000000000000020212121
00000000000000000000000020212121
1111120000000000f000000020212121
21212202000000000000000020212121
21212311111111111111111124212121
21212121212121212121212121212121
21212121212121212121212121212121
21212121212121212121212121212121
21212121212121212121212121212121

image image:tiles
location 5 8
