21212121212121212202002526272021
21212121212121212202002526272021
31313131313131313202002526272021
41414141414141414202002526272021
61616161616161616202002526272021
00000000000000000000002526272021
00000000000000000000002526272021
1111120000000000f000002526272021
21212202000000000000002526272021
21212311111215161616162926272021
2121212121222a262626262626272021
2121212121222a261836363636372021
2121212121222a262710111111112421
2121212121222a262720212121212121

image image:tiles
location 5 8
