21211331313131313202002526272021
21212240414141414202002526272021
31313260616161616202002526272021
41414202000000000000002526272021
61616202000000000000002526272021
00000000000000000000002526272021
00000000000000000000002526272021
11111200000000000000002526272021
21212202000000000000002526272021
21212311111215161616162926272021
2121212121222a262626262626272021
2121212121222a261836363636372021
2121212121222a262710111111112421
2121212121222a262720212121212121

image image:tiles
location 5 8
sprite @8,7 sprite:tank 0x00000000
sprite @5,4 sprite:tank 0x00000000
