21212121212121212121212121212121
21212121212121212121212121212121
21212121211331313131313131313131
21212121212240414141414141414141
21212121212260616161616161616161
21212121212202000000000000000000
21212121212202f00000000000000000
21212121212202000010111111111111
21212121212202000020212121212121
21212121212202000020212121212121
21212121212202000020212121212121
21212121212202000020212121212121
21212121212202000020212121212121
21212121212202000020212121212121

image image:tiles
location 4 8
