13313131313131313131313131142121
22404141414165664f41414142202121
22606161616155565f61616162303131
22020000000000000000000000404141
22020000000000000000000000606161
22020000000000000000000000000000
22020000001011111200000000000000
22020000003031313202000000000010
22020000004041414202000000000020
22020000006061616202000000000020
22020000000000000000000000000020
22020000000000000000000000000020
22020000000000000000000000000020
23111111111202000010111111111124

image image:tiles
location 4 8
sprite @10,9 sprite:caterpillar 0x00000000
sprite @6,4 sprite:caterpillar 0x00000000
sprite @3,8 sprite:caterpillar 0x00000000
sprite @2,4 sprite:bubblesaur 0x00000000
