21212121212202000020212121212121
21133131313202000030313131313131
21224041414202000040414141414141
31326061616202000060616161616161
41420200000000000000000000151616
61620200000000000000000000252626
161616161616162b1616161616292626
26262626262626262626262626262626
26262626262626262626262626262626
363636363636363b3636363636363636
11111111111202000000000000000000
21212121212202000000000000000000
21212121212202000000000000000000
21212121212311111111111111111111

image image:tiles
location 4 9
sprite @4,5 sprite:caterpillar 0x00000000
sprite @10,4 sprite:bug 0x00000000
