21212121212202000020212121212121
21212121212202000020212121212121
21212121212202000020212121212121
21212121212202000020212121212121
21212121212202000030313131313131
21212121212202000040414141414141
21212121212202000060616161616161
21212121212202000000000000000000
2121212121220200f000000000000000
21212121212202000000000000000000
21212121212311111111111111111111
21212121212121212121212121212121
21212121212121212121212121212121
21212121212121212121212121212121

image image:tiles
location 4 9
