21212121212202000020212121212121
31313131313202000030313131313131
41414141414202000040414141414141
61616161616202000060616161616161
16161616161616001616161616161616
26262626262626262626262626262626
36363636363636003636363636363636
11111111111200000000000000000000
21212121212202000000000000000000
21212121212202000000000000000000
21212121212311111111111111111111
21212121212121212121212121212121
21212121212121212121212121212121
21212121212121212121212121212121

image image:tiles
location 4 9
