21212121212121212121212121212121
21212121212121212121212121212121
21212121212121212121212121212121
21212121212121212121212121212121
31313131313131313131313131313131
41414141414141414141414141414141
61616161616161616161616161616161
00000000000000000000000000000000
0000000000000000f000000000000000
00000000000000000000000000000000
11111111111111111111111111111111
21212121212121212121212121212121
21212121212121212121212121212121
21212121212121212121212121212121

image image:tiles
location 5 9
