2121212121222a262720212121212121
3131313131322a262720212121212121
4141414141422a262720212121212121
6161616161622a262720212121212121
16161616161629262730313131313131
26262626262626262740414141414141
18363636363619262760616161616161
2700000000002a262700000000000000
27000000000000000000000000000000
3700000000002a262700000000000000
0000001011122a262710111111111111
0000002021222a262720212121212121
0000002021222a262720212121212121
1111112421222a262720212121212121

image image:tiles
location 5 9
sprite @10,7 sprite:flamethrower 0x02 2 (u16:fld)one
sprite @4,7 sprite:flamethrower 0x02 2 (u16:fld)one
