2121212121222a262720212121212121
2121212121222a262720212121212121
2121212121222a262720212121212121
2121212121222a262720212121212121
3131313131322a262730313131313131
4141414141422a262740414141414141
6161616161622a262760616161616161
0000000000002a262700000000000000
000000f0000000000000000000000000
0000000000002a262700000000000000
1111111111122a262710111111111111
2121212121222a262720212121212121
2121212121222a262720212121212121
2121212121222a262720212121212121

image image:tiles
location 5 9
