13313131313132020030313131313114
22404141414142020040414141414220
22606161616162020060616161616220
22020000000000000000000000000020
22020000000000000000000000000020
22020000000000000000000000000030
22020000000000000000000000000040
22020000000000000000000000000060
22020000000000000000000000000000
22020000000000000000000000000000
22020000000000000000000000000000
22020000000000000000000000000010
22020000000000000000000000000020
23111111111111111111111111111124

image image:tiles
location 3 6
sprite @5,8 sprite:treasure (u8:fld)got_compass 0x000000
