21212121212121212121212121212121
21133131313131313131313131311421
21220000000000000000000000002021
21220000000000000000000000002021
21220000000000000000000000002021
21220000000000000000000000002021
21220000000000000000000000002021
21220000000000000000000000003031
21220000000000000000000000000000
21220000000000000000000000000000
21220000000000000000000000001011
21220000000000000000000000002021
21231111111111111111111111112421
21212121212121212121212121212121

image image:tiles
neighbors 0x0000 0x0001 0x0000 0x0000
