13313131313132020030313131313114
22404f454641420200404f4b4c414220
22605f555661620200605f5b5c616220
22020000000000000000000000000020
32020000000000000000000000000020
42020000000000101200000000000030
62020010120000303202000000000040
00000030320200404202001012000060
00000040420200606202002022020000
12020060620200000000002022020000
22020000000000000000002022020000
22020000000000000000002023111111
22020000000000000000002021212121
23111200001011111111112421212121

image image:tiles
location 3 6
sprite @10,12 sprite:treasure (u8:fld)got_pepper 0x08 0x01 0x00
sprite @8,9 sprite:bug 0x00000000
sprite @3,5 sprite:bug 0x00000000
sprite @11,6 sprite:bug 0x00000000
