13313131313132020030313131313114
22404141414142020040414141414220
22606161616162020060616161616220
22020000000000000000000000000020
32020000000000000000000000000020
42020000000000000000000000000030
62020000000000000000000000000040
00000000000000000000000000000060
00000000000000000000000000000000
12020000000000000000000000000000
22020000000000000000000000000000
22020000000000000000f00000000010
22020000000000000000000000000020
23111200001011111111111111111124

image image:tiles
location 3 6
sprite @8,12 sprite:treasure (u8:fld)got_pepper 0x08 0x01 0x00
