21212121212121212121212121212121
21133131313131313131313131313131
21224041414141414141414141414141
21226061616161616161616161616161
21220200000000000000000000000000
21220200000000000000000000000000
21220200010101010101010101010101
21220200010101010101010101010101
21220200010103010103010101010101
21220200010103010103010100000000
21220200010103010103010100001011
21220200010103010103010100002021
21220200000000000000000000002021
21231111111111111111111111112421

image image:tiles
location 4 5
