21212121212202000000002021212121
21212121212202000000002021212121
21212113313202000000002021212121
21212122404202000000002021212121
31313132606202000000003031142121
41414142020000000000004042202121
61616162020000000000006062202121
00000000000015161616170000202121
00000000000025262626270000202121
00000000000035363636370000202121
11111111111111111111120000202121
21212121212121212121231111242121
21212121212121212121212121212121
21212121212121212121212121212121

image image:tiles
location 6 9
sprite @12,8 sprite:treasure (u8:fld)got_snowglobe 0x000000
sprite @11,10 sprite:flamethrower 0x40 3 0x0001
