21212121212202000000002021212121
21212121212202000000002021212121
21212121212202000000002021212121
21212121212202000000002021212121
31313131313202000000002021212121
41414141414202000000002021212121
61616161616202000000002021212121
0000000000000000f000002021212121
00000000000000000000002021212121
00000000000000000000002021212121
11111111111111111111112421212121
21212121212121212121212121212121
21212121212121212121212121212121
21212121212121212121212121212121

image image:tiles
location 6 9
sprite @9,8 sprite:treasure (u8:fld)got_snowglobe 0x000000
