21212121212121220220212121212121
21212121211331320230311421212121
21212121212240420240422021212121
21212121212260620260622021212121
21212121212202000000002021212121
21212121212202000000002021212121
2121212121220200f000002021212121
21212121212202000000002021212121
21212121212202000000002021212121
21212121212202000000002021212121
21212121212202000000002021212121
21212121212202000000002021212121
21212121212202000000002021212121
21212121212202000000002021212121

image image:tiles
location 6 8
