21212121212121220220212121212121
21211331313131320230313131142121
21212240414141420240414142202121
21212260616161620260616162202121
21212202000000000000000000202121
21212202000000000000000000202121
21212202000000101112000000202121
21212202000000303132020000202121
21212202000000404142020000202121
21212202000000606162020000202121
21212202000000000000000000202121
21212202000000000000000000202121
21212311111111111200001011242121
21212121212121212202002021212121

image image:tiles
location 6 8
sprite @11,7 sprite:caterpillar 0x00000000
sprite @4,7 sprite:caterpillar 0x00000000
sprite @5,11 sprite:caterpillar 0x00000000
