21212121212121212121220200000020
21212121212121212121220200000020
21212121211331313131320200000020
21212121212240414141420200000020
21212121212260616161620200000020
21212121212202000000000000000020
2121212121220200f000000000000020
21212121212202f0f0f0000000000020
2121212121220200f000001011111124
2121212121220200f000002021212121
2121212121220200f000002021212121
21212121212202000000002021212121
21212121212202000000002021212121
21212121212202000000002021212121

image image:tiles
location 6 7
