21212121212121212121220200000020
21212121212121212121220200000020
21133131313131313131320200000020
21224041414141414141420200000020
21226061616161616161620200000020
21220200000000000000000000000020
212202f0f000f0f00000000000000020
212202f0000000f00000000000000020
212202f0000000f0f000001011111124
21220200000000000000002021212121
2122020000000000f000002021212121
2122020000000000f000002021212121
21231111111200f0f0f0002021212121
2121212121220200f000002021212121

image image:tiles
location 6 7
