21212121212121212121212121212121
21133131313131313131313114212121
21224041414141414141414220212121
21226061616161616161616220212121
21220200000000000000000020212121
21220200000000000000000020212121
212202000000000000f0000020212121
21220200000000000000000020212121
21220200000000000000000020212121
21220200000000000000000020212121
21231111111111111112000020212121
21212121212121212122020020212121
21212121212121212122020020212121
21212121212121212122020020212121

image image:tiles
location 8 5
sprite @6,6 sprite:princess 0x00000000
