21133131313131313131313131313114
21226441414141414164404241414220
2122737475797a737475777873747520
2122838586898a838586878883848620
2122939596999a939596979893949620
21220200000000000000000000000020
21220200000000000000000000000020
21220200000000000000000000000020
21220200000000000000000000000020
21220200000000000000000000000020
21220200000000000000000000000020
21220200000000000000000000000020
21231111111111111112000010111124
21212121212121212122020020212121

image image:tiles
location 8 5
sprite @6,6 sprite:boss 0x00000000
switchable @13,4 (u16:fld)boss_dead
switchable @13,3 (u16:fld)boss_dead
sprite @13,5 sprite:princess 0x00000000
sprite @14,11 sprite:bossfire 0x00000000
sprite @2,11 sprite:bossfire 0x00000000
