1331313131322a262730313131313114
2240414141422a262740414141414220
2260616161622a262760616161616220
22020000000025262816161616161720
22020000000025261836191836192720
22020000000425262700252700252720
22020000000025262816292816292720
22020000000035363636363636363720
2202000c0d0d0d0d0d0d0d0d0d0d0e20
22020000000000000000000000000020
2202000c0d0d0d0d0d0d0d0d0d0e0720
23111111111111111200000000000020
21212121212121212202000000000020
21212121212121212311111111111124

image image:tiles
location 5 10
sprite @11,12 sprite:treasure (u8:fld)sq2 0x000000
sprite @12,5 sprite:flamethrower 0x02 5 (u16:fld)one
sprite @9,5 sprite:flamethrower 0x02 5 (u16:fld)one
treadle @5,5 (u16:fld)sq2a
switchable @14,10 (u16:fld)sq2a
