1331313131322a262730313131313114
2240414141422a262740414141414220
2260616161622a262760616161616220
22000000000035363700000000000020
22000000000000000000000000000020
22000000000000000000000000000020
22000000000000000000000000000020
22000000000000000000000000000020
22000000f0f000000000000000000020
22000000f00000f0f000000000000020
220000f0f00000f0f000000000000020
2200000000000000f000000000000020
2200000000000000f0f0000000000020
23111111111111111111111111111124

image image:tiles
location 5 10
