21212121212121212121212121212121
13313131313131313131313131313131
22404141414141414141414141414141
22606161616161616161616161616161
22020000000000000000000000151616
220200f0f00000000000000000252626
220200f00000f0f00000000000353636
2202f0f00000f0f00000000000001011
22020000000000f00000000000002021
22020000000000f0f000000000002021
22020000000000000000000000002021
22020000000000000000000000002021
22020000000000000000000000002021
23111111111111111111111111112421

image image:tiles
location 3 9
