21212121212121212121212121212121
13313131313131313131313114212121
22404141414141414141414220212121
22606161616161616161616230313131
22020000000000000000000040414141
220200f0f00000000000000060616161
220200f00000f0f00000000000001516
2202f0f00000f0f00000000000002526
22020000000000f00000000000002526
22020000000000f0f000000000003536
22020000000000000000000000001011
22020000000000000000000000002021
22020000000000000000000000002021
23111111111111111111111111112421

image image:tiles
location 3 9
