21212121212121212121212121212121
13313131313131313131313131311421
22404141414141414141414141422021
22606161616161616161616161623031
22021516161616170015161616174041
22022518363619281629183619276061
22022527000025262626270025281616
22022527000025262626270025262626
22022527000025262626270025262626
222a2927000025262626270035363636
222a2627000025262626270000001011
222a2628161629262626270000002021
223a3636363636363636370000002021
23111111111111111111111111112421

image image:tiles
location 3 9
sprite @1,4 sprite:treasure (u8:fld)sq3 0x000000
sprite @8,4 sprite:flamethrower 0x02 8 (u16:fld)one
