21212121212121212121212121212121
21133131313131313131313131311421
21220000000000000000000000002021
21220000000000000000000000002021
21220000000000000000000000002021
21220000000000000000000000002021
21220000000000000000000000002021
21220000000000000000000000002021
21220000000000000000000000002021
21220000000000000000000000002021
21220000000000000000000000002021
21220000000000000000000000002021
21231111111111120000101111112421
21212121212121220000202121212121

image image:tiles
location 5 4
