13313131313131313131313131313114
22404141414141414141414141414230
22606161616161616161616161616240
22020000000000000000000000000060
22020000000000000000000000000000
32020033000000000000000000000000
42020000000000000000000034000000
62020000000000000000000000000010
00000000000000000000000000000020
00000000000000000000000000000020
00000000000010111111111200000020
11111111111124212121212202000020
21212121212121212121212202000020
21212121212121212121212311111124

image image:tiles
location 4 6
sprite @13,11 sprite:treasure (u8:fld)got_compass 0x000000
sprite @2,5 sprite:tank 0x00000000
sprite @8,7 sprite:tank 0x00000000
sprite @5,4 sprite:tank 0x00000000
sprite @13,10 sprite:tank 0x00000000
