21212121212121212121212121212121
21133131313131313131313131311421
21224041414141414141414141422021
21226061616161616161616161622021
21220200000000000000000000002021
21220200000000000000000000002021
21220200101111111200000000002021
21220200303131313202000000002021
21220200404141414202000000002021
21220200606161616202000000002021
21220200000000000000000000002021
21220200000000000000000000002021
21231100111111120010111111112421
21212100212121220020212121212121

image image:tiles
location 5 4
