13313131313131313131313131313114
22404141414141414141414141414230
22606161616161616161616161616240
22020000000000000000000000000060
22020000000000000000000000000000
32020000000000000000000000000000
42020000000000000000000000000000
62020000000000000000000000000010
00000000000000000000000000000020
00000000000000000000000000000020
00000000000000000000000000000020
12000000000000000000000000000020
22020000000000000000000000000020
23111111111111111111111111111124

image image:tiles
location 4 6
sprite @4,5 sprite:treasure (u8:fld)got_pepper 0x08 0x01 0x00
