13313131313131313131313131313114
2240414147484f4141414b4c4f414230
2260616157585f6161615b5c5f616240
22020000000000000000000000000060
22020000000000000000000000000000
3202003c000000000000000000000000
4202000000000000000000003c000000
62020000000000000000000000000010
00000000000000000000000000000020
00000000000000000000000000000020
00000000000010111111111200000020
11111111111124212121212202000020
21212121212121212121212202000020
21212121212121212121212311111124

image image:tiles
location 4 6
sprite @13,11 sprite:treasure (u8:fld)got_compass 0x000000
sprite @2,5 sprite:tank 0x00000000
sprite @8,7 sprite:tank 0x00000000
sprite @5,4 sprite:tank 0x00000000
sprite @13,10 sprite:tank 0x00000000
