212121212121222a2626262626262626
313131313131322a2618363636361926
414141414141422a2627000000002526
616161616161622a1837000000002526
16161616161616292700000000002526
36363636363636363700000000002526
00000000000000000000000000002526
00000000000000000000000000002526
16170000000000000000000000002526
26270000000000000000000000002526
26270000000000000000000000002526
26270000000000000000000000002526
26281616161616161616161616162926
26262626262626262626262626262626

image image:tiles
location 6 5
sprite @11,4 sprite:bubblesaur 0x00000000
