21212121212122252626262626262626
31313131313132252618363636361926
16161616161616292627000000002526
26262626262626261837000000002526
26262626262626262700000000002526
36363636363636363700000000002526
00000000000000000000000000002526
00000000000000000000000000002526
16170000000000000000000000002526
26270000000000000000000000002526
26270000000000000000000000002526
26270000000000000000000000002526
26281616161616161616161616162926
26262626262626262626262626262626

image image:tiles
location 6 5
