21212121222a26272021212121212121
31313131322a26273031311421212121
41414141422a26274041422021212121
61616161622a26276061622021212121
00000000002526281616172021212121
00000000002526262626272021212121
00000000003536361926272021212121
11120000001011122526273031313131
21220200002021222a26274041414141
21220200002021222a26276061616161
21231111112421222a26270000000000
21212121212121222a26270000000000
21212121212121222a26270000000000
21212121212121222a26271011111111

image image:tiles
location 5 6
sprite @3,8 sprite:treasure (u8:fld)got_broom 0x000000
