13313131313131313131313131313114
32404141414141414141414141414220
42606161616161616161616161616220
62020000000000000000000000000020
00000000000000000000000000000020
00000000000000000000000000000020
00000000000000000000000000000020
12000000000000000000000000000030
220200000000000000f0000000000040
22020000000000000000000000000060
22020000000000000000000000000000
22020000000000000000000000000000
22020000000000000000000000000000
23111111111111111111111111111111

image image:tiles
location 5 6
sprite @12,5 sprite:treasure (u8:fld)got_broom 0x000000
