21222a26262627002526262600262626
21222a18363637003536363600353619
21222a27000000000000000000000025
21222a27000000000000000000000025
21222a27000000000000000000000025
21222a27000000000000000000000025
21222a27000015161616170000000025
21222a27000025262626270000000025
21222a27000025262626270000000025
21222a27000025262626270000000025
21222a27000035363636370000000025
21222a27000000000000000000000025
21222a27000000000000000000000025
21222a28161616161616161616161629

image image:tiles
location 5 6
