13313131313131313131313131313114
22404141414141414141414141414220
22606161616161616161616161616230
22020000000000000000000000000040
22020000000000000000000000000060
22020000000000000000000000000000
22020000000000000000000000000000
32020000000000000000000000000000
42020000000000000000000000000010
62020000f000f00000f0000000000020
0000000000f00000f0f0f0f0f0000020
00000000f000f00000f0000000000020
00000000000000000000000000000020
11111111111111111111120000000020

image image:tiles
location 6 6
sprite @4,5 sprite:treasure (u8:fld)got_bomb 0x08 0x01 0x00
