21222a26262627000025262626262626
21222a18363637000035363636361926
21222a27000000000000000000002526
21222a27000000000000000000002526
21222a27000000000000000000002526
21222a27000000000000000000002526
21222a27000000000000000000002526
21222a27000000000000000000002526
21222a27000000000000000000002526
21222a27000000000000000000002526
21222a27000000000000000000002526
21222a27000000000000000000002526
21222a28161616161616161616162926
21222a26262626262626262626262626

image image:tiles
location 5 6
