13313131313131313131313131313114
22404141414141414141414141414220
22606161616161616161616161616230
22020000000000000000000000000040
22020000000000000000000000000060
22020000000000000000000000000000
22020000000000000000000000000000
32020000000000000000000000000000
42020000000000000000000910111111
62020000f00000000010120030313114
00000000000000000020220240414220
00000000000000000020220260616220
00000000000000000020220200000020
11111111111111111124220200000020

image image:tiles
location 6 6
sprite @4,5 sprite:treasure (u8:fld)got_camera 0x000000
bombable @11,8 (u16:fld)bombctr
