21222526262627000025262626262626
21222518363637000035363636361926
21222527000000000000000000002526
21222527000000000000000000002526
21222527000000000000000000002526
21222527000000000000000000002526
21222527000000000000000000002526
21222527000000000000000000002526
21222527000000000000000000002526
21222527000000000000000000002526
21222527000000000000000000002526
21222527000000000000000000002526
21222528161616161616161616162926
21222526262626262626262626262626

image image:tiles
neighbors 0 0 1 0
