13313131313131313131313131313114
224067684f4141414141414141414220
3260595a5f6161616161616161616220
42020000000000000015161700000020
62020000000000000035363700000020
00000000000015161700000015161720
00000000000025262700000025262720
00000000000025262700000025262730
12000000000025262816161629262740
22020000000035363636363636363760
22020000000000000000000000000000
22020000000000000000000000000000
22020000000000000000000000000010
23111111111111111111111111111124

image image:tiles
location 7 6
sprite @3,11 sprite:treasure (u8:fld)got_wand 0x000000
sprite @13,3 sprite:treasure (u8:fld)got_candy 0x08 1 0
sprite @10,6 sprite:bubblesaur 0x00000000
