13313131313131313131313131313114
22404141414141414141414141414220
32606161616161616161616161616220
42020000000000000000000000000020
62020000000000000000000000000020
00000000000000000000000000000030
00000000000000000000000000000040
00000000000000000000000000000060
12000000000000000000000000000000
22020000000000000000000000000000
22020000000000000000000000000000
22020000000000000000000000000010
22020000000000000000000000000020
23111111111111111111111111111124

image image:tiles
location 7 6
sprite @4,10 sprite:treasure (u8:fld)got_wand 0x000000
