13313131313131313131313131313131
22404141414141414141414141414141
22606161616161616161616161616161
22020000000000000000000000000000
22020000000000000000000000000000
32020000000000000000000000000010
42020000000000000000000000000020
62020000000000000000000000000020
00000000000000000000000000000020
00000000000000000000000000000020
00000000000000000000000000000020
12000000000000000000000000000020
22020000000000000000000000000020
23111111111111111111111111111124

image image:tiles
location 8 6
sprite @4,5 sprite:treasure (u8:fld)got_broom 0x000000
