13313131313114133132020030313131
22404141414220224042020040414141
22606161616220226062020060616161
22020000000020220200000000000000
22020000000020220200000000000000
22020000000020231111111112000010
22020000000030313131313132020020
321a1616161740414141414142020020
423a3636363760616161616162020020
6202000000f000f00000f00000000020
000000000000f00000f0f0f0f0f00020
0000000000f000f00000f00000000020
12020000000000000000000000000020
22020000101111111111111111111124

image image:tiles
location 8 6
sprite @3,3 sprite:treasure (u8:fld)got_stopwatch 0x000000
sprite @5,6 sprite:trap 0x00000000
sprite @1,6 sprite:trap 0x00000000
sprite @1,3 sprite:trap 0x00000000
sprite @5,3 sprite:trap 0x00000000
sprite @8,4 sprite:treasure (u8:fld)got_pepper 0x08 0x01 0x00
