31313131313131313131313131313114
41414141414141414141414141414220
61616161616161616161616161616220
00000000000000000000000000000020
00000000000000000000000000000030
12000000000000000000000000000040
22020000000000000000000000000060
22020000000000000000000000000000
22020000000000000000000000000000
22020000000000000000000000000000
22020000000000000000000000000010
22020000000000000000000000000020
22020000000000000000000000000020
23111111111111111111111111111124

image image:tiles
location 9 6
sprite @3,10 sprite:treasure (u8:fld)got_camera 0x000000
