31313131313131313131313131313114
41414141414141414141414141414220
61616161616161616161616161616220
00000000000000000000000000000020
00000000000000000000000000000020
1200000000000000f0f0f00000000020
22020000000000000000f00000000020
2202f0f000f0f00000f0f00000000020
2202f00000f0f000f000000000000020
2202f00000f0f000f0f0f00000000020
220200000000f0000000000000000020
220200000000f0f00000000000000020
22020000000000000000000000000020
23111111111111111200000010111124

image image:tiles
location 9 6
