31313131313131313131313114212121
41414141414f4b4c4141414220212121
61616161615f5b5c6161616220212121
00000004000000000000000020212121
00000000000000101111120720212121
120c0d0d0d0e00201331320220212121
22020000000000202240420220212121
22020c0d0d0d0e202260620220212121
22020000000000202202000020212121
220f0d0d0d0e00202202000020212121
22020000000000202202000020212121
22020400000000202202000020212121
22020000000000202202000020212121
23111111111111242202000020212121

image image:tiles
location 9 6
sprite @11,2 sprite:flagand (u8:fld)twin1_a (u8:fld)twin1_b (u8:fld)twin1_c 0
treadle @3,3 (u16:fld)twin1_a
treadle @2,11 (u16:fld)twin1_b
switchable @11,4 (u16:fld)twin1_c
