13313131313131313131313131313114
22404141414141414141414141414220
22606161616161616161616161616230
22020000000000000000000000000040
32020000000000000000000000000060
42020000000000000000000000000000
62020000000000000000000000000000
00000000000000000000000000000000
00000000000000000000000000000010
00000000000000000000000000000020
12000000000000000000000000000020
22020000000000000000000000000020
22020000000000000000000000000020
23111111111111111111111111111124

image image:tiles
location 10 6
sprite @10,11 sprite:treasure (u8:fld)got_snowglobe 0x000000
