21212121212121212202000020212121
21212121212121212202000020212121
21212121212121212202000020212121
21212121212121212202000020212121
31313131313131313202000030313114
41414141414141414202000040414220
61616161616161616202000060616220
00000000090000000000000000000020
00000000090000000000000000000020
00000000090000000000000000000020
11111111111111111111111111111124
21212121212121212121212121212121
21212121212121212121212121212121
21212121212121212121212121212121

image image:tiles
location 9 7
sprite @13,8 sprite:treasure (u8:fld)got_bomb 0x08 1 0
bombable @4,9 (u16:fld)bombe
bombable @4,7 (u16:fld)bombe
bombable @4,8 (u16:fld)bombe
